6 13 31
###############################
#p   *        *   * * *      *#
# # # # #*# # #*# # # # # #*# #
#    * *   * **      *    **  #
#*# # # # # # # #b# # # # # #*#
#    *     *     *f      * 6**#
# # #*# # # # # #*#*# #*# # # #
#   *        *   * x * *      #
# # # # #*# # # # # # #*# #*# #
#   **b*         *       6    #
# # # # # # # # # #*# # # # # #
#   * *   *            **     #
###############################

6 - Boss