7 13 31
###############################
#p    * **    *        *      #
# # # #*# # # # # # # #   # # #
#       * * *  *   * **   *   #
# # # # # #*# # # # # # #*# # #
#*   * *    *   *   **7       #
# # # # # # # # # # # # # #*# #
#    *     *        *    **   #
# #*#   #*# # #*# # # # # #*# #
#        *   * *    *   *     #
#*# # # #   # # # # # #*# # #*#
# *    * **7   ** *x*         #
###############################